00000000000000000000
00000000000000001000
00000000000000001000
00000000000001000000
00000000000001000000
00000000011100000000
00000000111000000000
00000001110000000000
00000011100000000011
11111111000000000000
