000000000000
001010000000
001010000000
001010000000
001010000090
000000000010
010001000000
010001001000
001110000000
000000000000
000000010000
000000000000
000000000000
000000100000
000000000000
111111111111
