000000000000
000000000000
000000000000
000000000000
000000000000
000000000000
000000000000
000000000000
000000000000
000000000000
000000000000
000000000000
900000000000
000000000000
000000000000
000000000000
000000000000
000000000000
000000000000
333333333033
333333333033
333333333833
