001010000000
001010000000
001010000000
001010000090
000010100010
010001100000
010001001000
001110000000
000000000000
000000010000
000000000000
000000000000
000000100000
000000000000
111111111111
