0000000000011000000000000000001110001111000111000000000000000000000000000000000000000000000000000000
0000011100000000000000000000001000000000000000000100000000000000000000000000000000000000000000000000
0000000000000000000000000000001000000000000000001000000000000000000000000000000000000000000000000000
1000000000000001000000000000001000000000000000000000000000000000000000000000000000000000000000000000
1100000000000010001000000000001000000000000001000000000000000000000000000000000000000000000000000000
0110000000000100000001000110000001110011000010000000000000000000000000000000000000000000000000000000
0011000000001000000000000000000000000000000000000000000000000000000000000000000000000000000000000000
0000000000010000000000000000000000000000001000000000000000000000000000000000000000000000000000000000
1111111100000000000000000000000000000000010000000000000000000000000000000000000000000000000000000000
1100000000000000000000000000000010101011100000000000000000000000000000000000000000000000000000000000
1100000000000000000000000000000010100000000000000000000000000000000000000000000000000000000000000000
1100000000000000000000000000010110000000000000000000000000000000000000000000000000000000000000000000
1100000000000000000000000100011110000000000000000000000000000000000000000000000000000000000000000000
1100000000000000000000100100000000000000000000000000000000000000000000000000000000000000000000000000
1100000000000000000000100000000000000000000000000000000000000000000000000000000000000000000000000000
1111111111111111110110000000000000000000000000000000000000000000000000000000000000000000000000000000
