00000000000000000000000000000000000000000000000000000000000
00000000000000000000000000000000000000000000000000000000000
00000000000000000000000000000000000000000000000000000000000
00000000000000000000000000000000000000000000000000000000000
00000000011100000000000111000000000000000000000000000000000
00000000000000000000000000000000000000000000000000000000000
00000000111111111111000000000111111000001111111000000011100
11111111111111111111111111111111111000001111111100000000000
11111111111111111111111111111111111000001111111110000000000
11111111111111111111111111111111111000001111111111111111111