000000000000
000000000000
000000000000
000000000900
001010000000
001010000000
000000001110
010001000000
010001000000
011111000000
000000000000
000000000000
000000000000
000000000000
000000000000
111111111111
