22222210222220222222200000000000000002000122222222
22222210020200222222200000000000000020000112222222
22222210000000222222200000001000000222222112222222
22222210200020111111100000002000000020000122222222
22222210022200000000000000000000000002000122222222
22222210000000000000000000100001000000000122222222
22222210000000100100100000200002000000000122222222
22222210000000100100100000000000001111100122222222
22222211100011111111111111000000000222000112222222
22222222100012222222222221000000000000001112222222
22222222100012222222222221000000000000002112222222
22222222100012211111111121000000000000000122222222
22222222100012210000000121000000000000011122222222
22222222100012210000000121000000000000022122222222
22222222100012210000000121000000000011000122222222
22222222100012210000000121000000000022000122222222
22222222100012210000000121000000011000000122222222
22222222100012210000000111000000022000000122222222
22222222100012210000000000000011000000000122222222
22222222100012210000000000000021000000000122222222
22222222100012210000000111011021100000000112222222
22222222111112210000000121022022100000000112222222
22222222222222210000000121000000000000000111222222
22222222222222210000011121000000000000000112222222
22222211111111110000012221000000001000000122222222
22222210000000000000012221000000002000000122222222
22222210000000000001112221000000100000000122222222
22222210000000000001222221000000200000000122222222
22222210000000000001222221000010000000000112222222
22222210000000011111222221000020000000000112222222
22222210000000012222222221000000000000000112222222
22222210000000011222222221001000000000000122222222
22222210001110001111111121002000000000000122222222
22222210000200000000000121000010000000000122222222
22222210000000000000000111000020000000000112222222
22222211100000000000000001000000000000000112222222
22222211110000000000000001000000100000000112222222
22222211000000000000111101000000200000000112222222
22222210000111110000000100000010000000000112222222
22222210000022200000000100000020000000000112222222
22222210090000000000000100001000000000000112222222
22222211111111111111111101111111111111111112222222
22222211111111111221111101121111122111111122222222
22222222112222122222222101222211222222222222222222
22222222222222222222222101222221222222222222222222
22222222222222222222222101222222222222222222222222
22222222222222222222222101222222222222222222222222
22222222222222222222222101222222222222222222222222
22222222222222222222222101222222222222222222222222
22222222222222222222222101222222222222222222222222