00000000000000000000030000000000000000000000000000
11111110000000000333003000000000000000000000000000
22222200000000000000030000000000000000000000000000
22222200000000000000000000000000000000000000000000
22222000000000000000000000000000000000000000000000
22220000000000000000000000000000000000000000000000
22000000000000000000000000000000000000000000000000
20000001111100000000000000000000000000000000000000
00000102222200000000000000000000000000000000000000
00000000222000111100000000000000000000000000000000
00000000222000033000000000000000000000000000000000
00100000222000000000000000000000000000000000000000
00000000222010000000000000000000000000000000000000
00000000020020000000000000000000000000000000000000
00000000020000000000000000000000000000000000000000
00001000020000000000000000111100000000000000000000
00000000020000100000000000033000000000000000000000
00000000020000200000000000000000011110000000000000
01000000020000000000000000000000022220000000000000
00000000020000000000000000000000022220000000000000
00000000020010000000000000000000022220000000000000
00001000020020000000000000000000022220000000000000
00002000020000000000000000000000022220000000000000
00002100020000000000000000000011022221111110000000
10012211120000001111111111111122122222222221000000
20122222221111112222222222222222222222222222100000
20022222222222222222222222222222222222222222210000
20022222222222222222222220002222222222222222220000
33033223333222332222222000000002222222222222000000
33003333333333332222220000000000000022222200000000
33003333333333333222220000000000000000222000000000
33300000333333333222221000000000000000000000000000
33300000033333333332222100000000000000000000011111
33300000033333333333322210000000000000000000002220
33333330033333333333333221000001110000000000000000
33333300033333333333333322000000200000000000000000
33333000333333333333322222000000000001111000000000
00000003333333333322222222000000000000220000000000
00000333332222222222222220000000000000000000100000
00022333332222222222000000000000000000000000200000
00022233332220000000000000000000000000000000000000
10002233333220000000011000000000000000000000001000
20002233333220000000122000111000000000000000002000
20002233333220000001222000020000000000000000000000
00002233333220000112222000000000000000000000100000
02002233333228001222222000000000000000000000200000
92002233333221112233222000000000000000000000000000
12112233333222223333222000000000000000000000000000
22222333333233333333332000000000000000000000001000
33222333333333333333332111111111111111111111112111
