222222222222
222222222222
222222222222
222222222222
112222111111
012222100000
012222100000
012222190000
112222111111
222222222222
222222222222
222222222222
222222222222
222222222222
222222222222
222222222222
